11111111111111111111
11111881114222511111
S2222251113181311111
11111138883111311111
11111172226111311111
11111111118811311111
11111111142222611111
11111111138888111111
11111111172222222222C
11111111111111111111
11111111111111111111
